###############
#S............#
#############.#
#            F#
###############
