###########
#S#.......#
#.#.#####.#
#...#   #.#
##### ###.#
#     #...#
# ### #.###
# # # #.# #
# # # #.# #
#   #  ..F#
###########
